1111111111111
10C0000000001
100000E000001
100000000C001
1111111111111
