1111111111111
10C0000000001
1000000C00001
1P00000000C01
1111111111111
