1111111111111111111111111111111
10C00001100C010C000C000011000C1
100100C0000C0000111100C00110001
10011100C0000000C00001000C00001
10000C00000111000000C0000111001
100C00001110001000000C000000001
100C00000C00000C000000001111001
10000000C0111100000C00010000001
10001110000C00000000E0000000001
10C0000C00000011111000000000001
10000P000000C000000000111000001
1111111111111111111111111111111
