1111111111111
10C0000000001
100P00E000001
100P00000C001
1111111111111