1111111111111111111111111111111
1P0000000000000C000000000000001
1011111111111111111111111111101
100000000C0000001111000C0000101
1010111111111110100000111110101
10100000C00000001000000C0000001
1010101111111110101011111110101
101010100000C000001010000000101
1010101011111110111011111110101
10100000000000C00000000C0000001
1C11111111111111111111111111101
1000000000C0000000000000000E001
1111111111111111111111111111111
